
NO	./assets/textures/north.xpm
SO ./assets/textures/south.xpm
EA ./assets/textures/east.xpm
WE ./assets/textures/west.xpm

C 0,0,0
F 0,0,0

111111111111111111111
100000000000000000001
100000000000000000001
1111110N0001111111111
111111111111111111111

111111111111111111111
100000000000000000001
100000000000000000001
111111000001111111111
111111111111111111111
