

SO ./assets/textures/south.xpm

NO ./assets/textures/north.xpm

WE ./assets/textures/west.xpm

EA ./assets/textures/east.xpm

F 255,0,50
C 		 250,250,0

           1111111111111111111111111
           1000000000110000000000001
           1011000001110000000000001
           1001000000000000000000001
111111111011000001110000000000001
100000000011000001111111111111111
11110111111111111100000010101
111111111111110111010100O0001
11000000110101011100000010001
10000000000000000000000010S01
10000000000000001101010010001
1100000111010101111101111000111
11110111 1110101 101111010001
11111111 1111111 111111111111
