SO ./assets/textures/Revan.xpm

NO ./assets/textures/Plagueis.xpm

WE ./assets/textures/Nihilus.xpm

EA ./assets/textures/Krayt.xpm

F 170,0,0
C 170,0,0

11111111111111111111111111111111111
11001000000011100001000000000011111
10001000000011100001000000000000011
10001000000011000001000000000000001
10001001100000000001000001111110001
10001000110000000000000011000000001
10001000011000000000000110000000001
10000000001000000000000100000000001
10000000000000001111000100000010001
10000000000000001000000000000000001
1000N001100100000000000000000000001
10000000000000000000000100110000001
10000000000000000010000000000000001
10001000000100011110000000000000001
10000000000100000000000010000000001
10000000001100000000000011000010001
10000000011000000000000001100010001
10000000011000000000000001100010001
10000000000000010000011000000010001
11000000000000010000111000000010001
11111000000000010000111000000010011
11111111111111111111111111111111111
